######..........[#
................=#
|..........#.....%
####.#.........#.%
#................%
#................%
#................#
.......#...#....##
.@.#.............#
###............###