#...............[#
#...............=#
######...........#
.................#
|..........#.....%
####.#.........#.%
#................%
#................%
#................#
.......#...#....##
.@.#.............#
###............###