##############
#...........[#
#...........=#
#............#
#(..........(#
#............#
##(........(##
..............
.@....##.....|
####......####