###############
#....>.......[#
#............=#
#.............#
#.............#
#.............#
#.............#
...../////.....
.@............|
###.........###