##############
#...........[#
#...........=#
#............#
#............#
#............#
#............#
..............
.@....##.....|
###........###