################
#.............[#
#.............=#
#..............#
#..............#
#..............#
#..............#
................
.@.............|
###..........###